0,5420,4265,430,430,4266,4267,5614,5615,5616,3887,3888,5421,0,
0,1783,4457,3885,3886,4458,4459,5806,5807,5808,4079,4080,5613,0,
0,1975,4649,4077,4078,4650,4651,5998,1969,1969,4271,4272,5805,0,
0,2163,2163,2163,2163,1969,1969,1969,1969,1969,4268,1969,1969,0,
0,2353,2356,2358,2354,1969,1194,1195,1195,1195,1195,1195,1196,0,
0,2545,2155,2156,2355,1969,1386,1197,5609,5610,5611,1389,1388,0,
0,2550,2347,2348,2550,1969,1386,1197,5801,5802,5803,1389,1388,0,
0,2742,1195,1195,2742,1969,1578,1579,1579,1579,1579,1579,1580,0,
0,1969,1969,1969,1969,1969,1969,1969,1969,1969,1969,1969,1969,0,
0,1969,1969,1969,1969,1969,10221,10222,1969,1969,1969,1969,1969,0,
0,0,0,0,0,0,0,0,0,0,0,0,0,0,
0,0,0,0,0,0,0,0,0,0,0,0,0,0,
0,0,0,0,0,0,0,0,0,0,0,0,0,0,
0,0,0,0,0,0,0,0,0,0,0,0,0,0
a
2694,2694,2694,2694,2694,2694,2694,2694,2694,2694,2694,2694,2694,2694,
2694,2694,2694,2694,2694,2694,2694,2694,0,2694,2694,2694,2694,2694,
2694,0,0,0,0,0,0,0,0,0,0,0,0,2694,
2694,0,0,0,0,0,0,0,0,0,2694,0,0,2694,
2694,2694,2694,2694,2694,0,0,0,0,0,0,0,0,2694,
2694,2694,2694,2694,2694,0,0,2694,2694,2694,2694,2694,0,2694,
2694,2694,2694,2694,2694,0,0,2694,2694,2694,2694,2694,0,2694,
2694,2694,0,0,2694,0,0,0,0,0,0,0,0,2694,
2694,0,0,0,0,0,0,0,0,0,0,0,0,2694,
2694,0,0,0,0,0,0,0,0,0,0,0,0,2694,
2694,2694,2694,2694,2694,2694,2694,2694,2694,2694,2694,2694,2694,2694,
0,0,0,0,0,0,0,0,0,0,0,0,0,0,
0,0,0,0,0,0,0,0,0,0,0,0,0,0,
0,0,0,0,0,0,0,0,0,0,0,0,0,0